32,32@
33333333333333333333333333333333;
37222331111111111113311113444333;
32222331111111111113311114444333;
32222331111111111111111114444443;
34444331111113311111111114444443;
34444331111113311111111113444443;
34444331111113333333333333334433;
34444331111113333333333333311113;
33443331133113311111111116111113;
31111331133113311111111115111113;
31111331111113311111121113311113;
31111331111113311111222113311113;
31111331111333311112222113311113;
31111331111333311112222113311133;
31111331111111151111121113311133;
31111331111111161111111113311113;
31111331111111116111111113311113;
33111331122111115111111113311113;
33111331222211111333311113311113;
31111331222211111333311113311113;
31111331122211111331111113311113;
31111331112111111331111113311113;
31111151111111111331133113311113;
31111161111111111331133113334433;
31111333333333333331111113344443;
33443333333333333331111113344443;
34444431111111111331111113344443;
34444441111111111331111113344443;
34444441111111111111111113322223;
33344441111331111111111113322223;
33344431111331111111111113322283;
33333333333333333333333333333333$
