32,32@
33333333333333333333333333333333;
31111111111111111111111111111113;
31111111111111111111111111111113;
31111111111111111111111111111113;
31111111111111111111111111111113;
31111111111111111111111111111113;
31111111111111111111111111111113;
31111111111111111111111111111113;
31111111111111111111111111111113;
31111111111111111111111111111113;
31111111111111111111111111111113;
31111111111111111111111111111113;
31111111111111111111111111111113;
31111111111111111111111111111113;
31111111111111111111111111111113;
31111111111111111111111111111113;
31111111111111111111111111111113;
31111111111111111111111111111113;
31111111111111111111111111111113;
31111111111111111111111111111113;
31111111111111111111111111111113;
31111111111111111111111111111113;
31111111111111111111111111111113;
31111111111111111111111111111113;
31111111111111111111111111111113;
31111111111111111111111111111113;
31111111111111111111111111111113;
31111111111111111111111111111113;
31111111111111111111111111111113;
31111111111111111111111111111113;
31111111111111111111111111111113;
33333333333333333333333333333333$
