33333333333333333333333333333333;
31111111111111111111111111111113;
31111111111111111111111111111113;
31111111111111111111111111111113;
31111111111111111111111111111113;
31111111111111111111111111111113;
31111111111111111111111111111113;
31111111111111111111111111111113;
32221111111111111111111111111113;
32222211111111111111111111111113;
32222221111111111111111111111113;
32222221111111111111111111111113;
32222222111111111111111111111113;
32222221111111111111111111111113;
32222222111111111111111111111113;
31111111111111111111111111111111;
31111111111111111111111111111111;
31111111111111111111111111111113;
31111111111111111111111111111113;
31111111111111111111111111111113;
31111111111111111111111111111113;
31111111111111111111111111111113;
31111111111111111111111111111113;
31111111111111111111111111111113;
32221111111111111111111111111113;
32222211111111111111111111111113;
32222221111111111111111111111113;
32222221111111111111111111111113;
32222222111111111111111111111113;
32222221111111111111111111111113;
32222222111111111111111111111113;
33333333333333333333333333333333$