32,32@
33333333333333333333333333333333;
31111111111111111111111111111113;
31133311111111111111111113113113;
31311111131311113311113313113113;
31131111313131131131131113333113;
31113111313131133331113113113113;
31333111313131131131331113113113;
31111111111111111111111111111113;
31111111111111111111111111111113;
31131111331111111111111111111113;
31111113113111133331111111111113;
31131113113111311131111111111113;
31131113113111333331111111111113;
31111111111111111131111111111113;
31111111111111111131111111111113;
31111111111111113311111111111111;
31111111111111111111111111111111;
31111111111111111111111111111113;
31111111111111111111111111111113;
31111111111111111111111111111113;
31111111111111111111111111111113;
31111111111111111111111111111113;
31111111111111111111111111111113;
31111111111111111111111111111113;
32221111111111111111111111111113;
32222211111111111111111111111113;
32222221111111111111111111111113;
32222221111111111111111111111113;
32222222111111111111111111111113;
32222221111111111111111111111113;
32222222111111111111111111111113;
33333333333333333333333333333333$
