32,32@
33333333333333333333333333333333;
32222331311113111111131111311113;
32222331111111111311111111111113;
32222331111311133333333311111313;
32222331111111132222222311131113;
32222333333311132222222311111113;
31211111111311132222222311311113;
31111111111333332222222311111113;
31111111111111111111111311113113;
31112222211111111111111311111113;
31112111211113111111111311111113;
31112131211111111111111311133113;
31112111211111111111111311111113;
31112222211133333311111311311113;
31111111111131111313111311111113;
31111111111131111311111311111111;
33333333333331111311111311133331;
33333333311111112311311311131113;
33333333311111122311111311333113;
31111111111111222311111311113113;
31111111111111222333111311111113;
31133111111112222333111311111113;
31133111111111333333111311111133;
31111111111111111111111311111113;
31111113333111111111111311331113;
31111113333111111111111311111113;
31111113333333333333333311111113;
31111113333111111113331111131113;
31111113333111111113331111111113;
31111111111111111111111111111113;
31111111111111333111111111111113;
33333333333333333333333333333333$
